.#.#.#.#.#.#.#.#.
.#. .O. . .A. .#.
.#. . . . . . .#.
.#.x.O. . . . .#.
.#. . . .O. . .#.
.#.#.#.#.#.#.#.#.
