.#.#.#.#.#.#.#.#.#.
.#.#.#. . .#.#.#.#.
.#. . . . . .O. .#.
.#. .#. . .#.O. .#.
.#. .x. .x.#.A. .#.
.#.#.#.#.#.#.#.#.#.
